버스 = bus
바나나 = banana
마우스 = mouse
시소 = seesaw
아디다스 = adidas
표 = ticket
치즈 = cheese
모자 = hat
포도 = raison
하마 = hippopotamus
요가 = yoga
커피 = coffee
라디오 = radio
피아노 = piano
주스 = juice
토마토 = tomato
기타 = guitar
피자 = pizza
파리 = Paris
가위 = scissors
우리 = we
음료수 = drink
그리고 = and
빵 = bread
집 = house
매점 = school store
친구 = friend
한국어 = Korean language
밥 = rice
사진 = picture
책 = book
텔레비전 = television
지금 = now
영화 = movie
오늘 = today
어디 = where
비싸요 = expensive
사과 = apple
약 = medecine
맥주 = beer
어제 = yesterday
장소 = place
학교 = school
대학교 = university
기숙사 = dormitory
한학촌 = korean traditional village
도서관 = library
교실 = classroom
서점 = bookstore
커피숍 = coffee shop
한국어 학당 = Korean language center
식당 = restaurant
은행 = bank
편의점 = convenience store
산 = mountain
공원 = park
영화관 = theater
백화점 = department store
병원 = hospital
약국 = pharmacy
시내 = downtown
시장 = market
영국 = UK
독일 = Germany
핀란드 = Finlande
러시아 = Russia
한국 = South Korea
일본 = Japan
캐나다 = Canada
프랑스 = France
중국 = China
태국 = Thailande
호주 = Australia
베트남 = Vietnam
미국 = US
브라질 = Brazil
회사원 = employee
의사 = doctor
간호사 = nurse
경찰 = cops
학생 = student
미용사 = hairdresser
선생님 = teacher
요리사 = cook
운동하다 = to workout
만나다 = to meet
찍다 = to take a picture
보다 = to watch
배우다 = to learn
가르치다 = to teach
이야기하다 = to talk
마시다 = to drink
먹다 = to eat
공부하다 = to study
읽다 = to read
하다 = to do
사다 = to buy
산책하다 = to take a walk
요리하다 = to cook
빨래하다 = to do laundry
숙제하다 = to do homework
노래하다 = to sing
샤워하다 = to take a shower
쉬다 = to rest
기다리다 = to wait
전화하다 = to call
청소하다 = to clean
쇼핑하다 = to do shopping